F 		25, 240  , 200


SO			 ./ressources/textures/test


                  NO          ./ressources/textures/test


EA	 		 		 	 	 	     	  	 	 	  	 	 	 	 	  ./ressources/textures/test
C	 		 	255, 200, 1

				   WE				        ./ressources/textures/test

			  111
111111111111111111111111111111
110000000000111010000000100001
111100110000010111111110111101
    		10
1111111111110001111110001001
11111111111111111111111111111111111


